00000000000000111000000000000000001110000000000000000011100000000000000000111000
00000000000000000001000000000000000000010000000000000000000100000000000000000001
10011100011100111011100111000111001110111001110001110011101110011100011100111011
11000000000000000000110000000000000000001100000000000000000011000000000000000000
00111000111000111001001110001110001110010011100011100011100100111000111000111001
00000000000000000000000000000000000000000000000000000000000000000000000000000000
00000001110001110011000000011100011100110000000111000111001100000001110001110011
00011100000000000000000111000000000000000001110000000000000000011100000000000000
00000000001110000000000000000011100000000000000000111000000000000000001110000000
00000000000000111000002000000000001110000000200000000011100000000000000000111000
00000000000000000000002000000000000000000000200000000000000000000000000000000000
11111111111111111111111111111111111111111111111111111111111111111111111111111111