00000000000000111000
00000000000000000001
10011100011100111011
11000000000000000000
00111000111000111001
00000000000000000000
00000001110001110011
00011100000000000000
00000000001110000000
00000000000000111000
00000000000000000000
11111111111111111111